11111111111111111111111111111111111111111111111
1.............................................1
1.............................................1
1.............................................1
1.............................................1
1.......11111......11111.........11111111111111
1.......1..............1................11....1
1.......1..............1................11....1
1.......1..............1..............111111111
1.......1..............1................11....1
1.......................................11....1
1..............11................11111111111111
1..............11.............................1
1......................................111....1
1.......1..............1...............111....1
1.......1..............1.............1........1
1.......1..............1.............1........1
1.......1..............1........1.1111...111111
1.......11111......11111........1........1....1
1...............................1...11111111..1
1...............................11111......1..1
1........................................1.1..1
1................................111111111.1..1
1.............................1111..1......1..1
1.............................1.....1.11...1..1
1.............................1.....111111.1..1
1..........................11111111.11...1..P.1
1..........................1..................1
11111111111111111111111111111111111111111111111
